4 4 4 4 1 4 1 4 4 4 4 1 4 4 1 4
4 4 1 4 4 4 4 4 1 4 4 4 4 4 0 0 
4 4 4 4 4 4 4 4 4 4 4 4 4 0 0 0    
4 4 4 4 4 4 4 4 4 4 4 4 0 0 0 0
4 4 4 4 4 4 3 3 3 4 4 4 0 0 6 0 
4 4 4 4 4 4 4 4 4 4 4 4 0 0 0 0 
4 4 4 4 4 4 4 4 4 4 4 4 0 0 0 0 
4 4 4 4 4 4 4 4 4 4 4 4 0 0 0 0 
4 4 3 3 3 4 4 4 4 4 3 3 3 0 0 0 
4 4 4 4 4 4 4 4 4 4 4 4 0 0 0 0 
4 4 4 4 4 4 4 4 4 4 4 4 0 0 0 0 
2 2 2 2 2 5 5 5 5 5 2 2 2 2 2 2 