4 4 4 4 4 1 4 4 4 4 4 4 4 1 4 4
4 4 1 4 3 4 4 4 4 4 1 4 4 4 4 4
4 3 4 4 4 4 4 4 1 4 4 4 4 4 4 4
4 4 4 4 4 4 4 4 4 4 4 4 4 3 3 4
4 4 4 4 4 4 4 4 4 4 4 4 4 4 4 4
4 4 4 4 4 4 4 4 4 4 4 3 3 4 4 4
4 4 4 4 4 4 4 3 3 4 4 4 4 4 4 4
4 4 4 4 3 4 4 4 4 4 4 4 4 4 4 4
4 4 4 4 4 4 4 4 4 4 4 4 4 4 4 4
4 3 3 4 4 4 4 4 4 4 4 4 3 3 4 4
4 4 4 4 4 4 4 4 4 4 4 4 4 4 4 4
2 5 5 5 5 5 2 2 2 2 2 2 5 5 5 2